# Simple level

l 1

e 1

m ....................
m ...Y................
m ...............Y....
m ....................
m ....4...............
m ....................
m ....................
m .............p......
m ....................
m ...p................
m ....................
m ....................
m .......h.........Y..
m ....................
m ....................
m .............h......
m ....Y...............
m ....................
m ....................
m ....................
