# Arena vuota

e 0

m ....................
m ....................
m ......p.............
m ....................
m .........hhhh..4....
m ......hhpp..hh.......
m .........pphh.......
m .........4.Y..Y.....
m ....................
m ......h.............
m ....................
m ....................
m ....................
m ....................
m ....................
m ....................
m ....................
m ....................
m ....................
m ....................
