# Arena vuota

e 1

m ....................
m ....................
m ......p.............
m ....................
m .........hhhh..4....
m ......hhpp..hh......
m .........pphh.......
m .........4..........
m ....................
m ......h.............
m ....................
m ....................
m ....................
m ....................
m ....................
m ....................
m ....................
m ....................
m ....................
m ....................
