# Arena vuota

e 2

m ....................
m ....................
m ......p.............
m ....................
m .........hhhh..4....
m ......hhhh..hh.......
m .........hhhh.......
m .........4..........
m ....................
m ......h.............
m ....................
m ....................
m ....................
m ....................
m ....................
m ....................
m ....................
m ....................
m ....................
m ....................
